XXXXXXXXXXXXXX
S    X  X    X
X   XX X     X
X   X       XX
X X  X  X  X X
X            X
X  X    X  X X
X   X       XX
X            X
X       X    X
X     X   X  X
X X    X     X
X        X   E
XXXXXXXXXXXXXX
