XXXXXXXXXXXXXXXXXXXXXXXXXXXXXXXXXXXXXXXXXXXXXXXXXXXXXXXXXX
S   XX     X   X     XX   X  X    X X      X     XX X X  X
X   XX    X    XXXX  XX     XX X    X    X  XX    X X XX X
XXX X        XXXXX  X X X   XX X XX  XX    X XX   X X   XX
XXX       X  XX    X    X X X      X  X     X        X   X
X  X     X  X X X  X   X X    X         X X     XX       X
X X X XX X       X X  X    XX             X X       X    X
X     X X X XX        X  X               XXX    XXX X XX X
X X X   XX        X    X   X     XXX X XX XX  X       XX X
X XX   XXX   X XX     X X X  X  XXX X X     X XXX X  X  XX
X XXXX X  X  XX X        X         X X X       X X XXXX XX
X X          X X   XX  XX  X          X X X         X    X
XX    XX    X    XX X            X   X X         X  X X  X
X      XX X    X  X   X  X  X  X  XX         X  XXX   X  X
X XX  XXX     X  XX    X       X      XX  X  X  X   X XX X
XX   X XX  XX    XX X    XXX  X X  XX         X    XX X  X
X X    X               X  XX  XX       XX   X XX X       X
X XXX    X X      XX  XX XX  XX   XX  X  X X    X X      X
X       X  X  X  XX   X XXX  X X   XX X  XX  X X     X   X
X X X  XX      XXX X  X X  X  XX  XX  X    XX       X X XX
X     X XX X  X    XXX   X   X            X  XX         XX
XX      X   X X XX  X X X  XXXX X X  X  X     X  X    X XX
X     X    XX     X            XX       X X X      XX X  X
XX    XX    X XX X  XX  X      X   X X  X  X       X     X
X    XXXX X                  X     XXX    X          X X X
XX X  X X    X    X XXX X       X   X    X     X  X X X  X
X         X   X       X         X X  X    X      X X    XX
X      XXX XXXXX X   X    XX  XXX     X     X     XXX XX X
X  XX     X     X  X X X X    X X  XXX  XX           X   X
X X     XX       X   X  XX X      X         X       X XXXX
X  X   X  X  X    XX          X   X   XX     X    XXX XXXX
X        X   XX  X     XXX     XXXXXX       X X    XX X  X
X    X X X X       X  X   X  XX         XX XX      X X   X
X      X X X X X  X XX X XX   X       X        X      X  X
X   X X XX      XXXX   X XXX X   XX        X      X X   XX
X X          XXX     X   X     X   X X      XX       X   X
XXX X X  X      X      X  X    X X     XXXX   XX     X   X
X  X X        XX   XXXX  X  XX X XX       X X  X         X
X            XX X X     XX X X   XX X  X   X       X X   X
X XXX             X X X      XX  X X XX      X  X  X     X
X X  X    X X  XX  X X     X X    XX  X   XXX      X     X
X    XX   X XX      XX   X        X X  X     X X  XXX  XXX
X X  XX XX    X  XX  X X X  XX XXX    X   X X   X X X XX X
X   XX  XX  X    X  X   X XX XX X  X      XX  X    X XX  X
XX XX  X     XXX   XX   X  X X XX  X    X    X    X X  X X
XX XX X   XXX    X   X  XX   X   X X       X  X    X  X XX
X    XX  X     X        X       X  X    XX        XX X   X
X    XX  XX X           X   X  X   X       X X           X
X   X X       XXX  X  XX X X   X X      XX XXX X X X  XX X
X  X          XXX     X X         X  XX X    XXX    XX XXX
X     X X     X       X      X      XX   X   X    X    X X
X    X X      X      XXX X X    X   X XX XX X XX        XX
XX XX X  XX X   XXXX X      XX    XX            XX     X X
X       X X      XX    XX  X    X    X     XXXX X  X     X
XXX     X X     X  X  X        X  X    X  X  XX   XX X X X
X  X      X     X X  X XX   X XX       X   X X XXX XX   XX
XX     X XX X  X  X   XX XXXX X X XX     X  X    X       E
XXXXXXXXXXXXXXXXXXXXXXXXXXXXXXXXXXXXXXXXXXXXXXXXXXXXXXXXXX
